



SO ./textures/south.xpm
NO ./textures/north.xpm
WE ./textures/west.xpm

C 54,188,253
EA ./textures/east.xpm

F 80,150,40



         1111111111111111111111111111
        1000000000110000000000000000011
        1111111111110000000000001111011
        1001000000000000000000001  101
1111111111011000001110000000000001 111
100000000000000001110111111111111
1111011111111101110000000000001
1111011111111101110101001000001
1100000011010101110000001000001
11111111100000000000000001000001
11111111111111111111111011111111
        1000000000110000000000001
        111111111111000000000001
        1001000000000000000000001
111111111011000001110000000000001
100000000000000001110111111111111
1111011111111101110000000000001
1111011111111101110101001000001
1100000011010101110000001000001
1000000000000000000000001000001
1000000000000000110101001000001
110000011101010111110111100N0011
11110111 1110101 10111101000001
11111111 1111111 11111111111111